#################
#S#E____________#
#__############_#
#__#___###______#
#__##___________#
#_______________#
##_#__#__#__#___#
#__#____#_______#
#__#_______#____#
#______#________#
#################
