######################
#_____##_____##______#
#_________#__________#
#_____#_______#______#
#______######________#
#____________________#
#____________________#
#____________________#
#________#_#_________#
#________#S#_________#
#________#_#_________#
#_____##_____##______#
#_______#####________#
#____________________#
#____#################
#_########___________#
#_#___#_______#______#
#_#_#_#______###_____#
#_#_#_#_____##E##____#
#_#_#_#_____##_##____#
#___#_______#________#
######################
