############
#S_________#
#____#__##_#
#__###_###_#
#__#E______#
############
